############
#     x    #
#          #
#          #
#          #
#          #
#          #
#          #
#          #
#          #
#       A  #
############