############
#  #  x  # #
## # ### # #
#  # # # # #
## ### # # #
#        # #
## ####### #
#          #
# ######## #
# #   #    #
#   ##  # ##
######A#####